8,8
#### ###
####  ##
##### ##
#     ##
# ######
  ######
 #######
 #######